[
  {
    "x": 10,
    "y": 20,
    "w": 100,
    "h": 150
  },
  {
    "x": 30,
    "y": 40,
    "w": 200,
    "h": 250
  },
  {
    "x": 50,
    "y": 60,
    "w": 300,
    "h": 350
  }
]



